key,value
10.128.2.1,1
10.128.2.1,1
10.128.2.1,1
10.131.2.1,1
10.130.2.1,1
10.130.2.1,1
10.128.2.1,1
10.131.2.1,1
10.131.2.1,1
10.131.2.1,1
10.131.2.1,1
10.130.2.1,1
10.130.2.1,1
10.130.2.1,1
10.130.2.1,1
10.129.2.1,1
10.131.0.1,1
10.131.0.1,1
10.130.2.1,1
10.131.2.1,1
